#################################################################################
#..f....#...........#.....#.........#m..#.........#.#.......#...............#...#
#.#.###.#########.#.#.###.#.#.#####.#.#.#Q#.#####.#.#.###.###.#V#####.#####.#.#C#
#.#...#...........#t#.#.#...#.#...#.#.#.#.#.#.......#.#.#.....#.....#.#...#...#.#
#####.###############.#.#####.#.#.###.#.#.#.#########.#.###########.###.#.#####.#
#.....#...............#...#.#...#...#.#.#.#.........#.#...........#.....#.#...#e#
#.###.#.###############.#.#.#######.#I#.#.#########.#.###########.#####.#.#.#.#.#
#...#.#...#.....#.......#.....#.G.#.#.#.#.#.......#.#.....#.......#...#.#...#.#.#
###.#.###.#.#.#.###.###########.#.#.#.#.#.#####.#.#.#####.#.#.#####.#.#######.#.#
#...#.#...#.#.#...#.#...#.....#b#.#...#.#.......#.#.........#.#.....#.#...#...#.#
#.#####.###.#.###.#.#.#.#.###.#.#.#####.#########.#############.#####.#.#.#.###.#
#.......#.#.#...#.Z.#.#.B.#.....#.....#.#.......#.....#.........#.#.....#...#...#
#.#######.#.###.#####.#.#############.#M#.#.#########.#.#########.#.#############
#.#.......#...#.#.....#u#...K.......#.#.#.#...........#...#.........#...........#
#.###.###.#.###.#.#####.#.#####.###.#.#.#.#############.#.#.#########.#########.#
#...#...#...#...#.U.#...#.#..j#...#.#g..#.......#...R.#.#.#.....#.....#.......#.#
###.#######.#.#####.#####.#.#.###.#.#############.###.#.#.#######.#########.###.#
#.#.......#.#.....#..k....#.#.#d..#.#...#.........#...#.#.........#.#.......#...#
#.#######.#.#####.#####.###.#.#####.#.#.#.#########.###.#########.#.#.#.#####.#.#
#.....#...#.#.....#.H.#.#...#.S...#.D.#.#...#.....#.#...#.#.....#.#...#..a#...#.#
#.#.#.#.#####.#####.#.#.#.#######.#####.###.#.###.#.###.#.#.###.#.#.#####.#.###.#
#.#.#.#...#...#...#.#.#.#.#.....#.....#s#...#...#.#...#...#...#.#.#...#...#.#...#
###.#.###.#.###.#.#.#####J###.#######.#.#.#######.###.###.#####.#.#.###.#.#.#.###
#...#.#...#.#...#.#.#.....#...#.....#...#.#...#.....#.#...#...#.#.#.#...#.#.#...#
#.#####.###.#.###.#.###.###.###.#.#.#####.#.#.#.###.#.###.###.#.#.###.###.#.###.#
#.....#...#...#...#....h#...#...#.#.#...#...#.#.#.#.#...#.....#.#.....#...#.#.#.#
#.###.###.#.###.###########.#.###.#.###.#####.#.#.#.###.#######.#######.###.#.#.#
#.#.#.....#.#...#.....#...#...#.#.#.....#...#...#...#.#...#.....#.......#.#.#..p#
#.#.#########.###.#.#.#.#.###.#.#.#####.#.#######.###.###.#.###########.#.#.###.#
#.#.#.......#.....#.#...#...#...#.#...#.#.......#.#.#...#.#.......#...#.#.#...#.#
#.#.#.###.#.#.#####.#######.#####.###.#.#.#####.#.#.#.#.#.#######.#.#.#.#.###.#.#
#.#...#...#.#.....#.......#.....#...#...#.....#.#.#...#.#...#...#...#.#.#.#...#.#
#.#####.###.#####.#######.#####.###.#.###.#####.#.#####.#.###.#.#####.#.#.#.###.#
#...N.#.#.#.#.....#.......#...#.....#.#.#.#...#.#.......#.....#.......#...#...#.#
#####.#.#.#.#.#####.#######.#########.#.###.#.#.#######.#####################.#.#
#...#...#...#.....#.......#.#...#.....#.#...#.....#...X.#.....Y.#...#...W.....#.#
###.#####.#######.#######.#.#.#.#.#####.#.#########.#########.#.###.#.#.#######.#
#...#.....#...#.....#...#.#.#.#...#.....#.#.....#...#...#...#.#...#...#.#.#.....#
#.###.#####.#.#######.#.#.#.#.#######.#.#.#.###.#.###.#.#.#.#.###.#####.#.#.#####
#.........A.#.........#...#..x........#.......#.......#...#...#.........#.......#
#######################################.@.#######################################
#.O.......#.............#.......#.....................#...........#...#...#.#...#
###.#####.#######.#####.###.#.#.#.#####.#.#.#########.#######.###.#.#.#.#.#.#.#.#
#...#...#.......#.#..y....#.#.#.#.#...#.#.#.#.....#.........#...#.#.#...#.#.#.#.#
#.#####.#######.#.#.#####.###.#.#.#.#.#.###.#.###.#########.###.#.#.#####.#.#.#.#
#.#...#.......#.#.#.#...#.....#...#.#.#.#...#...#...#.....#.....#.#...#.#.#...#.#
#.#.#.#####.###.#.###.#.#############.#.#.#####.###.#.###.#######.###.#.#.#####.#
#..r#.#...#.....#.#.L.#.#...#...#.....#.#.........#.#.#...#.....#.....#.#.#..n..#
#####.#.#.###.###.#.###.#.#.#.#.###.###.#.#######.#.#.#.###.###.#######.#.#.#####
#...#...#...#..w..#.#.#.#.#.#.#...#...#.#...#...#.#...#...#.#...#.....#...#.....#
#.#.#######.#######.#.#.#.#.#.###.###.#.###.#.#.#######.#.#.#.#####.###.###.###.#
#.#...#...#.....#...#.#...#.....#...#.#.#.#.#.#.......#.#...#.#...#.#...#...#...#
###.#.#.#######.#.###.#########.###.#.#.#.#.#.#######.#.#####.#.#.#.#.#####.#.###
#...#...#...#.P.#.#...#.#.....#.#...#.#.#...#.#.#...#.#...#o#...#.#...#...#.#...#
#.#####.#.#.#.###.#.#.#.#.###.###.###.#.#.###.#.#.#.#.###.#.#####.#.###.#.#.###.#
#.....#.#.#.#.....#.#...#...#.....#...#.#...#.#...#.#.#.....#.....#.#...#.#...#.#
#.###.#.#.#.#######.#######.#########.#.#####.#.###.#.#.#####.#####.#.###.#.###.#
#.#.#.#.#.#...#.#.....#.....#...#...#.#.#.....#.#.#.#.#.#.....#...#.#...#.#.#...#
#.#.#.###.#.#.#.#.###.#.#####.#.#.#.#.#.#.#####.#.#.#.###.#####.###.###.#.###.###
#.#.#.E...#.#.#...#...#...#...#...#...#.#.....#.#.#.......#.........#..l#...#...#
#.#.#######.#.#####.###.#.#.#.#####.###.#####.#.#.#########.###.#####.#####.###.#
#.#.......#.#.....#.#.#.#.#.#.#...#.#...#.....#.#.#.....#...#.#.#...#.#...#.....#
#.#.#####.#.#####.#.#.#.#.###.#.#.###.###.#####.#.#.###.#####.#.#.#.#.###.#####.#
#.#.#.....#.#.......#.#.#.#...#.#.#...#.#.#.....#.#.#.#.....#.#...#...#...#.....#
#.#.#.#####.#.#######.#.#.#.###.#.#.###.#.#.#####.#.#.#####.#.#########.###.#####
#.#.#...#...#.#..q#...#.#.#.....#.#.#...#.#.#.....#.#.....#.#.......#...#...#...#
#.#.#.###.###.#.#.#.#####.#.#####.#.###.#.#.#.#.###.###.#.#.#######.#.#.#.#####.#
#.#.#.#...#.#...#.#.......#.....#.#...#.#.#...#.#v..#...#.#...#.....#.#.#.#...#.#
#.#.#.#.###.#.#################.#.###.#.#.###.###.###.#######.#.#####.###.#.#.#.#
#...#.#...#...#.............#...#...#.#.#...#.#...#.........#...#.......#...#...#
#.#####.#.#####.#.###########.#####.#.#.#.#.###.###########.#####.#####.#######.#
#.#...#.#.#.....#.....#.......#.....#.#.#.#...#.#...............#.#...#.......#.#
###.#.###.#.#########.#.#######.#####.#.#.###.#.#.#.#############.###.#####.###.#
#...#...#.#.#.........#.#.....#.....#.#.#.#...#.#.#....c..........#.....#.#.....#
#.#####.#.#.#.#########.#.#.#.#####.#.#.###.###.#.#################.###.#.#######
#.....#...#z#.......#...#.#.#...#.#.#.#.#...#...#.....#.....#...#...#.#.#.......#
#.###.#####.#######.#.###.#.###.#.#.#.#.#.###.#######.###.#.#.#.#.###.#.#T#.###.#
#...#.....#...#...#...#...#...#...#.#.#.#...#.#...#...#...#.#.#...#.#...#.#.#.#.#
###.#####.###.#.#.###########.###.#.#.#.#.#.#.#.###.###.###.#.#####.#F#####.#.#.#
#.......#.......#.............#...#.....#.#...#.........#.....#.............#i..#
#################################################################################